30
0 0 0 0 0 0 0 0 0 0 0 0 0 0 0 0 0 0 0 0 0 0 0 0 0 0 0 0 0 1
0 0 0 0 0 0 0 0 0 0 0 0 0 0 0 0 0 0 0 0 0 0 0 0 0 0 0 0 0 0
B B B B B 0 0 0 0 0 0 0 0 0 0 0 0 0 0 0 0 0 0 0 0 B B B B B
B B B B B 0 0 0 0 0 0 0 0 0 0 0 0 0 0 0 0 0 0 0 0 B B B B B
B B B B B 0 0 0 0 0 0 0 0 0 0 0 0 0 0 0 0 0 0 0 0 B B B B B
0 0 0 0 0 0 0 0 0 0 0 0 0 0 0 0 0 0 0 0 0 0 0 0 0 0 0 0 0 0
0 0 0 0 0 0 0 S S 0 0 0 0 0 0 0 0 0 0 0 0 S S 0 0 0 0 0 0 0
0 0 0 0 0 0 0 S S T T T T T T T T T T T T S S 0 0 0 0 0 0 0
0 0 0 0 0 0 0 S S W W W W W W W W W W W W S S 0 0 0 0 0 0 0
2 0 0 0 0 0 0 S S 0 0 0 0 0 0 0 0 0 0 0 0 S S 0 0 0 0 0 0 0
B B B B 0 0 0 0 0 0 0 0 0 0 0 0 0 0 0 0 0 0 0 0 0 0 B B B B
B B B B 0 0 0 0 0 0 0 0 0 0 0 0 0 0 0 0 0 0 0 0 0 0 B B B B
0 0 0 0 0 0 0 S S 0 0 0 0 0 0 0 0 0 0 0 0 S S 0 0 0 0 0 0 0
0 0 0 0 0 0 T S S 0 0 0 0 0 0 0 0 0 0 0 0 S S T 0 0 0 0 0 0
0 0 0 0 0 0 T S S B B B B B B B B B B B B S S T 0 0 0 0 0 0
0 0 0 0 0 0 T S S B B B B B B B B B B B B S S T 0 0 0 0 0 0
0 0 0 0 0 0 T S S 0 0 0 0 0 0 0 0 0 0 0 0 S S T 0 0 0 0 0 0
0 0 0 0 0 0 0 S S 0 0 0 0 0 0 0 0 0 0 0 0 S S 0 0 0 0 0 0 3
B B B B 0 0 0 0 0 0 0 0 0 0 0 0 0 0 0 0 0 0 0 0 0 0 B B B B
B B B B 0 0 0 0 0 0 0 0 0 0 0 0 0 0 0 0 0 0 0 0 0 0 B B B B
0 0 0 0 0 0 0 S S 0 0 0 0 0 0 0 0 0 0 0 0 S S 0 0 0 0 0 0 0
0 0 0 0 0 0 0 S S W W W W W W W W W W W W S S 0 0 0 0 0 0 0
0 0 0 0 0 0 0 S S T T T T T T T T T T T T S S 0 0 0 0 0 0 0
0 0 0 0 0 0 0 S S 0 0 0 0 0 0 0 0 0 0 0 0 S S 0 0 0 0 0 0 0
0 0 0 0 0 0 0 0 0 0 0 0 0 0 0 0 0 0 0 0 0 0 0 0 0 0 0 0 0 0
0 0 0 0 0 0 0 0 0 0 0 0 0 0 0 0 0 0 0 0 0 0 0 0 0 0 0 0 0 0
B B B B B 0 0 0 0 0 0 0 0 0 0 0 0 0 0 0 0 0 0 0 0 B B B B B
B B B B B 0 0 0 0 0 0 0 0 0 0 0 0 0 0 0 0 0 0 0 0 B B B B B
B B B B B 0 0 0 0 0 0 0 0 0 0 0 0 0 0 0 0 0 0 0 0 B B B B B
4 0 0 0 0 0 0 0 0 0 0 0 0 0 0 0 0 0 0 0 0 0 0 0 0 0 0 0 0 0
